<<
  <<"#", "#", " ", "#", "#", "#", "#", "#", "#", "#", " ", " ", " ", "$">>,
  <<"#", " ", " ", "#", " ", " ", " ", "#", "#", "#", " ", "#", "#", "#">>, 
  <<"#", " ", "#", "#", "#", "#", " ", " ", " ", " ", " ", " ", " ", "#">>,
  <<"#", " ", " ", " ", "#", "#", "#", "#", "#", "#", "#", "#", " ", "#">>, 
  <<"#", "#", "#", " ", "#", " ", "#", "#", " ", "#", "#", " ", " ", "#">>,
  <<"#", "#", "#", " ", " ", " ", "#", "#", " ", "#", "#", " ", "#", "#">>,
  <<"#", "#", "#", "#", "#", " ", "#", " ", " ", " ", " ", " ", "#", "#">>,
  <<"#", "#", " ", " ", " ", " ", "#", "#", "#", " ", "#", " ", "#", "#">>,
  <<"#", "#", " ", "#", "#", " ", " ", " ", "#", " ", "#", "#", "#", "#">>,
  <<"#", "#", " ", "#", "#", "#", "#", " ", " ", " ", "#", " ", "#", "#">>,
  <<"#", "#", " ", " ", "#", " ", "#", "#", "#", "#", "#", " ", "#", "#">>,
  <<"#", "#", "#", " ", "#", " ", " ", " ", " ", " ", " ", " ", " ", "#">>,
  <<" ", " ", " ", " ", " ", " ", "#", "#", "#", "#", "#", " ", "#", "#">>,
  <<"*", "#", " ", "#", "#", "#", "#", "#", "#", "#", "#", " ", "#", "#">>
>>