<<
  <<"#", "#", "#", "#", "#", "#", "#", "#", "#", "#", "#", "#", "#", "#", "#", "#", "#", "#", "#", "#", "#", "#", "#", "#", "#", "#", "#", "#", "#", "#", "#", "#">>,
  <<"#", "#", " ", " ", " ", " ", " ", " ", " ", " ", " ", " ", " ", " ", " ", "#", " ", " ", " ", " ", " ", " ", "#", "#", " ", " ", " ", " ", "#", " ", " ", "#">>,
  <<"#", " ", " ", "#", "#", "#", "#", "#", " ", "#", "#", "#", "#", "#", " ", "#", " ", "#", "#", "#", "#", " ", "#", "#", " ", "#", "#", " ", "#", " ", "#", "#">>,
  <<"#", " ", "#", "#", " ", " ", " ", "#", " ", " ", " ", " ", "#", "#", " ", "#", " ", " ", " ", "#", "#", " ", "#", "#", " ", "#", "#", " ", " ", " ", " ", "#">>,
  <<"#", " ", " ", "#", "#", "#", " ", "#", "#", "#", "#", " ", "#", "#", " ", "#", "#", "#", " ", "#", "#", " ", " ", " ", " ", "#", "#", "#", "#", "#", " ", "#">>,
  <<"#", " ", "#", "#", " ", "#", " ", " ", " ", " ", "#", " ", "#", "#", " ", "#", " ", "#", " ", " ", "#", "#", "#", "#", "#", "#", "#", " ", " ", " ", " ", "#">>,
  <<"#", " ", " ", " ", " ", " ", " ", " ", "#", "#", "#", " ", "#", "#", " ", "#", " ", "#", "#", " ", " ", " ", " ", " ", " ", " ", "#", " ", "#", "#", "#", "#">>,
  <<"#", "#", "#", " ", "#", "#", "#", " ", "#", "#", "#", " ", " ", "#", " ", "#", " ", " ", " ", " ", "#", "#", "#", "#", "#", " ", "#", " ", " ", " ", " ", "#">>,
  <<"#", " ", "#", " ", "#", " ", " ", " ", "#", " ", " ", " ", " ", "#", " ", "#", "#", "#", "#", "#", "#", "#", " ", " ", " ", " ", "#", "#", "#", "#", " ", "#">>,
  <<"#", " ", "#", " ", "#", "#", "#", "#", "#", " ", "#", "#", "#", "#", " ", "#", "#", " ", " ", " ", " ", " ", " ", "#", "#", "#", "#", " ", " ", " ", " ", "#">>,
  <<"#", " ", "#", " ", " ", " ", " ", "#", "#", " ", " ", "#", "#", " ", " ", "#", "#", " ", "#", "#", "#", "#", "#", "#", "#", "#", "#", " ", "#", "#", "#", "#">>,
  <<"#", " ", "#", "#", "#", "#", " ", " ", "#", "#", " ", "#", "#", " ", "#", "#", "#", " ", " ", " ", " ", "#", "#", "#", " ", "#", "#", " ", " ", " ", " ", "#">>,
  <<"#", " ", " ", " ", " ", "#", "#", " ", "#", "#", " ", "#", "#", " ", "#", "#", "#", "#", "#", "#", " ", "#", " ", " ", " ", "#", "#", "#", "#", "#", " ", "#">>,
  <<"#", "#", " ", "#", " ", "#", "#", " ", "#", "#", " ", "#", "#", " ", " ", " ", " ", " ", " ", " ", " ", "#", "#", "#", " ", "#", "#", " ", " ", " ", " ", "#">>,
  <<"#", " ", " ", "#", " ", "#", " ", " ", "#", "#", " ", "#", "#", "#", "#", "#", "#", "#", "#", "#", "#", "#", "#", " ", " ", " ", " ", " ", "#", "#", "#", "#">>,
  <<"#", " ", "#", "#", " ", " ", " ", "#", "#", "#", " ", " ", " ", " ", " ", " ", " ", " ", " ", " ", " ", " ", "#", "#", "#", "#", "#", " ", " ", " ", " ", "#">>,
  <<"#", " ", " ", "#", " ", "#", "#", "#", " ", "#", " ", "#", "#", " ", "#", "#", "#", "#", "#", " ", "#", "#", "#", "#", "#", "#", "#", "#", "#", "#", " ", "#">>,
  <<"#", "#", " ", "#", " ", " ", " ", "#", " ", " ", " ", "#", "#", " ", "#", "#", " ", " ", " ", " ", " ", " ", " ", " ", " ", " ", "#", " ", " ", " ", " ", "#">>,
  <<"#", "#", "#", "#", "#", "#", " ", "#", "#", "#", " ", " ", " ", " ", " ", "#", " ", "#", "#", " ", "#", "#", "#", "#", "#", "#", "#", " ", "#", "#", "#", "#">>,
  <<"#", " ", " ", " ", "#", "#", " ", " ", " ", "#", "#", "#", "#", "#", " ", "#", " ", " ", "#", " ", " ", " ", " ", " ", " ", " ", "#", " ", " ", " ", " ", "#">>,
  <<"#", " ", "#", " ", "#", "#", "#", "#", " ", " ", " ", " ", "#", "#", " ", "#", "#", "#", "#", "#", "#", "#", "#", "#", "#", "#", "#", "#", "#", "#", " ", "#">>,
  <<"#", " ", "#", " ", "#", " ", "#", "#", "#", "#", "#", " ", "#", "#", " ", " ", " ", "#", "#", "#", " ", " ", " ", " ", " ", " ", " ", " ", " ", " ", " ", "#">>,
  <<"#", " ", "#", " ", " ", " ", " ", " ", " ", " ", "#", " ", "#", "#", "#", "#", " ", " ", " ", "#", " ", "#", "#", "#", "#", "#", "#", "#", "#", "#", "#", "#">>,
  <<"#", " ", "#", "#", " ", "#", "#", "#", "#", "#", "#", " ", "#", " ", "#", "#", " ", "#", "#", "#", " ", "#", "#", " ", " ", " ", "#", "#", "#", "#", "#", "#">>,
  <<"#", " ", "#", "#", " ", "#", "#", " ", " ", " ", " ", " ", "#", " ", "#", "#", " ", " ", " ", "#", " ", "#", "#", " ", "#", " ", " ", " ", " ", " ", "#", "#">>,
  <<"#", " ", " ", "#", " ", "#", "#", " ", "#", "#", "#", "#", "#", " ", " ", "#", " ", "#", " ", "#", " ", "#", "#", " ", "#", "#", "#", "#", "#", " ", "#", "#">>,
  <<"#", "#", " ", "#", " ", "#", "#", " ", " ", " ", " ", "#", "#", " ", "#", "#", " ", "#", " ", "#", " ", "#", "#", " ", " ", " ", "#", "#", " ", " ", "#", "#">>,
  <<"#", " ", " ", "#", " ", "#", "#", "#", "#", "#", " ", "#", "#", " ", "#", " ", "#", "#", " ", "#", " ", "#", "#", "#", "#", " ", "#", "#", " ", "#", "#", "#">>,
  <<"#", " ", "#", "#", " ", "#", " ", " ", " ", " ", " ", "#", "#", " ", " ", " ", "#", "#", " ", "#", " ", " ", " ", "#", "#", " ", " ", " ", " ", "#", "#", "#">>,
  <<"#", " ", " ", "#", " ", "#", " ", "#", "#", "#", "#", "#", "#", "#", "#", " ", "#", "#", " ", "#", "#", "#", " ", " ", " ", " ", "#", "#", " ", " ", " ", "#">>,
  <<" ", " ", "#", "#", " ", " ", " ", " ", " ", " ", " ", " ", " ", " ", " ", " ", "#", "#", " ", " ", " ", "#", "#", "#", "#", " ", " ", " ", "#", "#", " ", "#">>,
  <<"*", "#", "#", "#", "#", "#", "#", "#", "#", "#", "#", "#", "#", "#", "#", "#", "#", "#", "#", "#", "#", "#", "#", "#", "#", "#", "#", "#", "#", "#", " ", "$">> 
>>